Header
25
1111111111111211111111111
1111111111111011111111111
1101111111111011111111111
1100000011111011111111111
1101111011111001111111111
1111111111111011111111111
1111111100000000111111111
1111111111111010000001111
1111111100011111111101111
1111111101110011111101111
1111111101100001111000111
1111100001111000011011111
1111101011111111111000001
1000001000011111111111103
1111111111011111111111101
1111111111011111111111101
1111111111011111111110001
1000000000000000011110101
1111111111101111111110101
1110000000000000000000101
1111101111111111111111101
1000000000000000000000001
1111111111111111111111111
1111111111111111111111111
1111111111111111111111111