Header
30
111111111111111111111111111111
111111111111111111111111111111
111111111111111111111111111111
111111111111111111111111111111
111111111111110111111111111111
111111111111110111111111111111
111111111111110111111111111111
111111100000000000000111111111
111111111111111111110111111111
111111111111111111110000000011
111111111111111111110111111111
111110000000000111110111111111
111111111111011111110111111111
111111111000011111110111111111
111111100011111111110111111111
111111111000000000000000011111
111111111110111111101111011111
111111110000000000001111011111
111111111111111011111111011111
111100000000000011111000000002
111111111111111011111010111111
111111111111000000000010000001
111111111111101111111111011101
111111111111101111111111011101
111111111111101111111100011101
111111111111111111111111111103
111111111111111111111111111111
111111111111111111111111111111
111111111111111111111111111111
111111111111111111111111111111