Header
30
111111111111111112111111111111
111111111111011110001111111111
111111111100011111101111111111
111111111111000000000111111111
111111111111101111110000000001
110000000000001000011111111111
110101111101110111000001111111
111100111101111111110111111111
111101111101111111110111111111
111101111111111111110111111111
300000011111111111110011111111
110111000011111111111011111111
110111011011111111110111111111
110111011011111111110111111111
110111011011111111110111111111
110111000000000000000111111111
110111111111111011111111111111
110111111111111011111111111111
110111111111111011111100001111
110000000001111011111101111111
111111111111111011111101111111
111111111111111001111101111111
111111111111111011111101111111
111111111111111000011101111111
111111111111111111000001111111
111111111111111111111111111111
111111111111111111111111111111
111111111111111111111111111111
111111111111111111111111111111
111111111111111111111111111111