Header
35
12111111111111111111111111111111111
10000011111111111111111111111111111
11111011111111111111111011111111111
11111011111111111111100011111111111
11000001111111111111101111111111111
11111011111111111111100111111111111
11111011111111111111101111111111111
11111000000000000000000000000000111
11111011111111111111111111111101111
11111011111111111111111111111101111
11110011111111111111111111111001111
11110111111111111111111111111101111
11110000111111111111111111111101111
11111110011111111111111111111101111
11111111011111111111111111111101111
11111111011111111111111111111101111
11111111000000111111111111111101111
11111111011111111111111111111001111
11111111011111111111111111111011111
11111100011111111111111111111011111
11111111000000000000000000000011111
11111111011111111111111111111011111
11111111000011111111111111111011111
11111111011111111111111111111011111
11111111000000000011111111111011111
11111111111111111111111111110011111
11111111111111111011111111100111111
11111111111111111011100000001111111
11111111111111111000001111101111111
11111111111111111111111111100111111
11111111111111111111111111110011111
11111111111111111111111111111011111
11111111111111111111111111111000001
11111111111111111111111111111111101
11111111111111111111111111111111131