Header
25
1211111111111111111111111
1001111111111111111111111
1101111111111111110000111
1100000011111111110111111
1101111011111111110111111
1111100001111111111111111
1111101100000000001111111
1111111111011111111111111
1111111100011111111111111
1111111101110011111111111
1111111101100001111111111
1111100001111000001111111
1111101011111111100111111
3000001000011111110111111
1111011101011111110111111
1111011101011111110111111
1000011101000000000111111
1011011101011111110111111
1011000001011111110111111
1011111111011111110111111
1000000000011111110000011
1111101111011111111111011
1111101111000000000000001
1111101111111111111111111
1111111111111111111111111