Header
30
111111111111111111111111111111
111111111101111111111111111111
111111111101111111111111111111
111111111101111111111111101111
111111111101111111111111100001
111000000000000000000000001101
111111110111111101111111101101
111111110111111100111110001101
111111110111111110001111101101
111111110111111111101111000002
111100000000000000111100010111
111111111111111110110110110103
111111111111111100000000111101
111111111111000001111111111101
111111111111011100000000000001
111111000000001111011111111111
111110011111100000000111111111
111111011111111101111111111111
111111011111111101111111111111
111111011111111101111111111111
111111011111111101111111111111
111111000000000001111111111111
111111111111111100011111111111
111111111111111111011111111111
111111111111111111000001111111
111111111111111111111111111111
111111111111111111111111111111
111111111111111111111111111111
111111111111111111111111111111
111111111111111111111111111111