Header
25
1111111111111211111111111
1111111111111011111111111
1101111111111011111111111
1100000011111011111111111
1101111011111001111111111
1111111111111011111111111
1111111100000000111111111
1111111111111010001001111
1111111100011011111101111
1111111101110011111101111
1111111101100001111000111
1111100001111000011011111
1111101011111011111000001
1000001000011011111111101
1111111111111011111111101
1000000000000011111111101
1010110111111000000001101
1110110001111111111111101
1110111101111000000000001
1110111101111011111111111
1111111100000011111111111
1111111111110011111111111
1111111111111011111111111
1111111111111011111111111
1111111111111311111111111
