Header
35
13111111111111111111111111111111111
10111111111111111111111111111111111
10000111111111111111111111111111111
11110111111111111111111111111111111
11110111111111111111111111111111111
11100111111111111111111111111111111
11110000011111111111111111111111111
11111011011111111111111111111111111
11111111000011111111111111111111111
11111111011011111111111111111111111
11110000011011111111111111111111111
11110111111011111111111111111111111
11110000000001111111111111111111111
11111011101111111111111111111111111
11111000000000000001111111111111111
11111101111111111101111111111111111
11111101111111111101111111111111111
11111100000000000001111111111111111
11100001111011111111111111111111111
11101111111011111111111111111111111
11101111111001111111111111111111111
11000001110011111111111111111111111
11111101110111111111111111111111111
11111101110111111111111111111111111
11111101000111111111111111111111111
11111101101111111111111111111111111
11100001101111111111111111111111111
11101111101111111111111111111111111
11100111101111111111111111111111111
11110011101111111111111111111111111
11111011101111111111111111111111111
11100011001111111111111111111111111
11101000011111111111111111111111111
10001111001111111111111111111111111
12111111111111111111111111111111111