Header
35
12111111111111111111111111111111111
10111111111111111111111111111111111
10000111111111111111111111111111111
11110111111111111111111111111111111
11110111111111111111111111111111111
11000111111111111111111111111111111
11010000000001111111111111111111111
11011011011111111111111111111111111
11011111000011111111111111111111111
11011111111111111111111111111111111
11000000011011111111111111111111111
11010110111011111111111111111111111
11000000000001111111111111111111111
11011011101111111111111111111111111
11000000000000000001111111111111111
11101101110111011101111111111111111
11101101110111011101111111111111111
11101100000000000001111111111111111
11100001011011110111111111111111111
11101111000011110111111111111111111
11101111011001110111111111111111111
11000001110011100111111111111111111
11111101110111110111111111111111111
11111101110111110111111111111111111
11111101000000000000001111111111111
11111101101111110111111111111111111
11100001101111110111111111111111111
11101111101111110111111111111111111
11100000001110010111111111111111111
11110011101111010111111111111111111
11111011101111000111111111111111111
11100011001111110111111111111111111
11101000011000000111111111111111111
10001111000011111111111111111111111
11111111131111111111111111111111111